1111111111111
10A1C000000E1
1C00011101111
10P0C1C000001
1111111111111