1111111111111
10A10000000E1
1000011101111
10P011C000001
1111111111111